16
################
#............K.#
#..............#
#P.............#
#..............#
#..............#
#..............#
#############DD#
#############DD#
#..............#
#..............#
#.............E#
#..............#
#..............#
#..............#
################