16
################
#..............#
#............K.#
#.P............#
#..............#
#..............#
#..............#
#DDMD###########
#..............#
#..............#
#..............#
#...........E..#
#..............#
#..............#
#..............#
################