16
################
#P............K#
#..............#
#..............#
#..............#
#..............#
#..............#
#######DD#######
#..............#
#..............#
#..............#
#.........S....#
#..............#
#..............#
#E.............#
################