16
################
#............K.#
#..............#
#.P............#
#.........G....#
#..............#
#..............#
#############DD#
#############DD#
#..............#
#..............#
#E.............#
#...........S..#
#..............#
#..............#
################